Jump to content Main menu Main menu move to sidebar hide Navigation Main page Contents Current events Random article About Wikipedia Contact us Contribute Help Learn to edit Community portal Recent changes Upload file Special pages Search Search Appearance Donate Create account Log in Personal tools Donate Create account Log in Pages for logged out editors learn more Contributions Talk CentralNotice Contents move to sidebar hide (Top) 1 History of biology 2 Overview 3 Chemical basis 4 Cells 5 Genetics 6 Evolution 7 Diversity 8 Plant form and function 9 Animal form and function 10 Ecology 11 Branches 12 Biologists 13 See also 14 References 15 External links Toggle the table of contents Outline of biology 9 languages العربية Español Hrvatski Bahasa Melayu Suomi தமிழ் ไทย Türkçe اردو Edit links Article Talk English Read Edit View history Tools Tools move to sidebar hide Actions Read Edit View history General What links here Related changes Upload file Permanent link Page information Cite this page Get shortened URL Download QR code Print/export Download as PDF Printable version In other projects Wikidata item Appearance move to sidebar hide From Wikipedia, the free encyclopedia See also: Index of biology articles Drosophila melanogaster , commonly used as a model organism The following outline is provided as an overview of and topical guide to Wikipedia articles on Biology .

Part of a series on Biology Index Outline Glossary History ( timeline ) Key components Cell theory Ecosystem Evolution Phylogeny Properties of life Adaptation Energy processing Growth Order Regulation Reproduction Response to environment Domains and Kingdoms of life Archaea Bacteria Eukarya ( Animals , Fungi , Plants , Protists ) Branches Abiogenesis Aerobiology Agronomy Agrostology Anatomy Anthropogeny Anthropology Astrobiology Bacteriology Biochemistry Biogeography Biogeology Bioinformatics Biological engineering Biomathematics Biomechanics Biophysics Biosemiotics Biostatistics Biotechnology Botany Cell biology Cellular microbiology Chemical biology Chronobiology Cognitive biology Computational biology Conservation biology Cryobiology Cytogenetics Dendrology Developmental biology Ecological genetics Ecology Embryology Epidemiology Epigenetics Evolutionary biology Freshwater biology Generative biology Genetics Genomics Geobiology Gerontology Herpetology Histology Human biology Ichthyology Immunology Lipidology Mammalogy Marine biology Microbiology Molecular biology Mycology Neontology Neuroscience Nutrition Ornithology Osteology Paleontology Parasitology Pathology Pharmacology Photobiology Phycology Phylogenetics Physiology Pomology Primatology Proteomics Protistology Quantum biology Relational biology Reproductive biology Sociobiology Structural biology Synthetic biology Systematics Systems biology Taxonomy Teratology Toxicology Virology Virophysics Welfare biology Xenobiology Zoology Research Biologist ( list) List of biology awards List of journals List of research methods List of unsolved problems Applications Agricultural science Biomedical sciences Health technology Pharming Biology portal Category v t e Biology – The natural science that studies life. Areas of focus include structure, function, growth, origin, evolution, distribution, and taxonomy.

History of biology [ edit ] Main article: History of biology See also: Timeline of biology and organic chemistry History of anatomy History of biochemistry History of biotechnology History of botany History of ecology History of genetics History of evolutionary thought : Darwinism Eclipse of Darwinism ( Lamarckism , Orthogenesis , Structuralism , and Mutationism ) Modern (evolutionary) synthesis History of molecular evolution History of speciation History of marine biology History of medicine History of model organisms History of molecular biology Natural history History of neuroscience History of plant systematics History of pathology History of virology History of zoology Overview [ edit ] Biology Science Life Properties: Adaptation – Energy processing – Growth – Order – Regulation – Reproduction – Response to environment Biological organization : atom – molecule – cell – tissue – organ – organ system – organism – population – community – ecosystem – biosphere Approach: Reductionism – emergent property – mechanistic Biology as a science : Natural science Scientific method : observation – research question – hypothesis – testability – prediction – experiment – data – statistics Scientific theory – scientific law Research method List of research methods in biology Scientific literature List of biology journals : peer review Chemical basis [ edit ] Outline of biochemistry Atoms and molecules matter – element – atom – proton – neutron – electron – Bohr model – isotope – chemical bond – ionic bond – ions – covalent bond – hydrogen bond – molecule Water : properties of water – solvent – cohesion – adhesion – surface tension – pH Organic compounds : carbon – carbon-carbon bonds – hydrocarbon – monosaccharide – amino acids – nucleotide – functional group – monomer – adenosine triphosphate (ATP) – lipids – oil – sugar – vitamins – neurotransmitter – wax Macromolecules : polysaccharide : cellulose – carbohydrate – chitin – glycogen – starch proteins : primary structure – secondary structure – tertiary structure – conformation – native state – protein folding – enzyme – receptor – transmembrane receptor – ion channel – membrane transporter – collagen – pigments : chlorophyll – carotenoid – xanthophyll – melanin – prion lipids : cell membrane – fats – phospholipids nucleic acids : DNA – RNA Cells [ edit ] Outline of cell biology Cell structure: Cell coined by Robert Hooke Techniques: cell culture – flow cytometry – microscope – light microscope – electron microscopy – SEM – TEM – live cell imaging Organelles : Cytoplasm – Vacuole – Peroxisome – Plastid Cell nucleus Nucleoplasm – Nucleolus – Chromatin – Chromosome Endomembrane system Nuclear envelope – Endoplasmic reticulum – Golgi apparatus – Vesicles – Lysosome Energy creators: Mitochondrion and Chloroplast Biological membranes : Plasma membrane – Mitochondrial membrane – Chloroplast membrane Other subcellular features: Cell wall – pseudopod – cytoskeleton – mitotic spindle – flagellum – cilium Cell transport: Diffusion – Osmosis – isotonic – active transport – phagocytosis Cellular reproduction: cytokinesis – centromere – meiosis Nuclear reproduction: mitosis – interphase – prophase – metaphase – anaphase – telophase programmed cell death – apoptosis – cell senescence Metabolism : enzyme - activation energy - proteolysis – cooperativity Cellular respiration Glycolysis – Pyruvate dehydrogenase complex – Citric acid cycle – electron transport chain – fermentation Photosynthesis light-dependent reactions – Calvin cycle Cell cycle mitosis – chromosome – haploid – diploid – polyploidy – prophase – metaphase – anaphase – telophase – cytokinesis – meiosis Genetics [ edit ] Outline of Genetics Inheritance heredity – Mendelian inheritance – gene – locus – trait – allele – polymorphism – homozygote – heterozygote – hybrid – hybridization – dihybrid cross – Punnett square – inbreeding genotype–phenotype distinction – genotype – phenotype – dominant gene – recessive gene genetic interactions – Mendel's law of segregation – genetic mosaic – maternal effect – penetrance – complementation – suppression – epistasis – genetic linkage Model organisms : Drosophila – Arabidopsis – Caenorhabditis elegans – mouse – Saccharomyces cerevisiae – Escherichia coli – Lambda phage – Xenopus – chicken – zebrafish – Ciona intestinalis – amphioxus Techniques: genetic screen – linkage map – genetic map DNA Nucleic acid double helix Nucleobase : adenine (A) – cytosine (C) – guanine (G) – thymine (T) – uracil (U) DNA replication – mutation – mutation rate – proofreading – DNA mismatch repair – point mutation – crossover – recombination – plasmid – transposon Gene expression Central dogma of molecular biology : nucleosome – genetic code – codon – transcription factor – transcription – translation – RNA – histone – telomere heterochromatin – promoter – RNA polymerase Protein biosynthesis – ribosomes Gene regulation operon – activator – repressor – corepressor – enhancer – alternative splicing Genomes DNA sequencing – high throughput sequencing – bioinformatics Proteome – proteomics – metabolome – metabolomics DNA paternity testing Biotechnology (see also Outline of biochemical techniques and Molecular biology ): DNA fingerprinting – genetic fingerprint – microsatellite – gene knockout – imprinting – RNA interference Genomics – computational biology – bioinformatics – gel electrophoresis – transformation – PCR – PCR mutagenesis – primer – chromosome walking – RFLP – restriction enzyme – sequencing – shotgun sequencing – cloning – culture – DNA microarray – electrophoresis – protein tag – affinity chromatography – x-ray diffraction – proteomics – mass spectrometry – CRISPR – gene therapy Genes, development, and evolution Apoptosis French flag model Pattern formation Evo-devo gene toolkit Transcription factor Evolution [ edit ] Outline of evolution (see also evolutionary biology ) Evolutionary processes evolution microevolution : adaptation – selection – natural selection – directional selection – sexual selection – genetic drift – sexual reproduction – asexual reproduction – colony – allele frequency – neutral theory of molecular evolution – population genetics – Hardy–Weinberg principle Speciation Species Phylogeny Lineage (evolution) – evolutionary tree – cladistics – species – taxon – clade – monophyletic – polyphyly – paraphyly – heredity – phenotypic trait – nucleic acid sequence – synapomorphy – homology – molecular clock – outgroup (cladistics) – maximum parsimony (phylogenetics) – Computational phylogenetics Linnaean taxonomy : Carl Linnaeus – domain (biology) – kingdom (biology) – phylum – class (biology) – order (biology) – family (biology) – genus – species Three-domain system : archaea – bacteria – eukaryote – protist – fungi – plant – animal Binomial nomenclature : scientific classification – Homo sapiens History of life Origin of life – hierarchy of life – Miller–Urey experiment Macroevolution : adaptive radiation – convergent evolution – extinction – mass extinction – fossil – taphonomy – geologic time – plate tectonics – continental drift – vicariance – Gondwana – Pangaea – endosymbiosis Diversity [ edit ] Bacteria and Archaea Protists Plant diversity Green algae Chlorophyta Charophyta Bryophytes Marchantiophyta Anthocerotophyta Moss Pteridophytes Lycopodiophyta Polypodiophyta Seed plants Cycadophyta Ginkgophyta Pinophyta Gnetophyta Magnoliophyta Fungi Yeast – mold (fungus) – mushroom Animal diversity Invertebrates : sponge – cnidarian – coral – jellyfish – Hydra (genus) – sea anemone flatworms – nematodes arthropods : crustacean – chelicerata – myriapoda – arachnids – insects – annelids – molluscs Vertebrates : fishes : – agnatha – chondrichthyes – osteichthyes Tiktaalik tetrapods amphibians reptiles birds flightless birds – Neognathae – dinosaurs mammals placental : primates marsupial monotreme Viruses DNA viruses – RNA viruses – retroviruses Plant form and function [ edit ] Plant body Organ systems: root – shoot – stem – leaf – flower Plant nutrition and transport Vascular tissue – bark (botany) – Casparian strip – turgor pressure – xylem – phloem – transpiration – wood – trunk (botany) Plant development tropism – taxis seed – cotyledon – meristem – apical meristem – vascular cambium – cork cambium alternation of generations – gametophyte – antheridium – archegonium – sporophyte – spore – sporangium Plant reproduction angiosperms – flower – reproduction – sperm – pollination – self-pollination – cross-pollination – nectar – pollen Plant responses Plant hormone – ripening – fruit – Ethylene as a plant hormone – toxin – pollinator – phototropism – skototropism – phototropin – phytochrome – auxin – photoperiodism – gravity Animal form and function [ edit ] General features: morphology (biology) – anatomy – physiology – biological tissues – organ (biology) – organ systems Water and salt balance Body fluids : osmotic pressure – ionic composition – volume Diffusion – osmosis ) – Tonicity – sodium – potassium – calcium – chloride Excretion Nutrition and digestion Digestive system : stomach – intestine – liver – nutrition – primary nutritional groups metabolism – kidney – excretion Breathing Respiratory system : lungs Circulation Circulatory system : heart – artery – vein – capillary – Blood – blood cell Lymphatic system : lymph node Muscle and movement Skeletal system : bone – cartilage – joint – tendon Muscular system : muscle – actin – myosin – reflex Nervous system Neuron – dendrite – axon – nerve – electrochemical gradient – electrophysiology – action potential – signal transduction – synapse – receptor – Central nervous system : brain – spinal cord limbic system – memory – vestibular system Peripheral nervous system Sensory nervous system : eye – vision – audition – proprioception – olfaction – Integumentary system : skin cell Hormonal control Endocrine system : hormone Animal reproduction Reproductive system : testes – ovary – pregnancy Fish#Reproductive system Mammalian reproductive system Human reproductive system Mammalian penis Os penis Penile spines Genitalia of bottlenose dolphins Genitalia of marsupials Equine reproductive system Even-toed ungulate#Genitourinary system Bull#Reproductive anatomy Carnivora#Reproductive system Fossa (animal)#External genitalia Female genitalia of spotted hyenas Cat anatomy#Genitalia Genitalia of dogs Canine penis Bulbus glandis Animal development stem cell – blastula – gastrula – egg (biology) – fetus – placenta - gamete – spermatid – ovum – zygote – embryo – cellular differentiation – morphogenesis – homeobox Immune system antibody – host – vaccine – immune cell – AIDS – T cell – leucocyte Animal behavior Behavior : mating – animal communication – seek shelter – migration (ecology) Fixed action pattern Altruism (biology) Ecology [ edit ] Outline of ecology Ecosystems : Ecology – Biodiversity – habitat – plankton – thermocline – saprobe Abiotic component : water – light – radiation – temperature – humidity – atmosphere – acidity Microbe – biomass – organic matter – decomposer – decomposition – carbon – nutrient cycling – solar energy – topography – tilt – Windward and leeward – precipitation Temperature – biome Populations Population ecology : organism – geographical area – sexual reproduction – population density – population growth – birth rate – death Rate – immigration rate – exponential growth – carrying capacity – logistic function – natural environment – competition (biology) – mating – biological dispersal – endemic (ecology) – growth curve (biology) – habitat – drinking water – resource – human population – technology – Green revolution Communities Community (ecology) – ecological niche – keystone species – mimicry – symbiosis – pollination – mutualism – commensalism – parasitism – predation – invasive species – environmental heterogeneity – edge effect Consumer–resource interactions : food chain – food web – autotroph – heterotrophs – herbivore – carnivore – trophic level Biosphere lithosphere – atmosphere – hydrosphere biogeochemical cycle : nitrogen cycle – carbon cycle – water cycle Climate change : Fossil fuel – coal – oil – natural gas – World energy consumption – Climate change feedback – Albedo – water vapor Carbon sink Conservation Biodiversity – habitats – Ecosystem services – biodiversity loss – extinction – Sustainability – Holocene extinction – bioremediation Branches [ edit ] See also: List of life sciences Anatomy – study of form in animals, plants and other organisms, or specifically in humans. Simply, the study of internal structure of living organisms.

Physiology – study of the internal workings of organisms and the functions of anatomical structures.

Comparative anatomy – the study of evolution of species through similarities and differences in their anatomy .

Gross anatomy – study of anatomy at the macroscopic level Histology – also known as microscopic anatomy or microanatomy, the branch of biology which studies the microscopic anatomy of biological tissues.

Neuroanatomy – the study of the nervous system .

Osteology – study of bones.

Radiographic anatomy – study of anatomy through radiography Surface anatomy – study of external features of a body Biochemistry – study of the chemical reactions required for life to exist and function, usually a focus on the cellular level.

Biophysics – study of biological processes through the methods traditionally used in the physical sciences.

Biomechanics – the study of the mechanics of living beings.

Cellular biophysics – study of physical principles underlying cell function Neurophysics – study of the development of the nervous system on a molecular level.

Molecular biophysics – study of physical properties of biomolecules at the molecular level Quantum biology – application of quantum mechanics and theoretical chemistry to biological objects and problems.

Virophysics – study of mechanics and dynamics driving the interactions between virus and cells.

Biotechnology – new and sometimes controversial branch of biology that studies the manipulation of living matter, including genetic modification and synthetic biology .

Bioinformatics – use of information technology for the study, collection, and storage of genomic and other biological data.

Bioengineering – study of biology through the means of engineering with an emphasis on applied knowledge and especially related to biotechnology.

Synthetic biology – research integrating biology and engineering; construction of biological functions not found in nature.

Botany – study of plants.

Economic botany – study of relationship between people and plants, including the practical uses of plants Ethnobotany – study of a region's plants and their usage by people Photobiology – scientific study of the interactions of light (technically, non-ionizing radiation) and living organisms. The field includes the study of photosynthesis, photomorphogenesis, visual processing, circadian rhythms, bioluminescence, and ultraviolet radiation effects.

Phycology – scientific study of algae.

Plant anatomy – study of internal structure of plants Plant ecology – study of how plants interact with each other and their environment Plant genetics – study of heredity and variation in plants Plant pathology – study of plant diseases Plant physiology – subdiscipline of botany concerned with the functioning, or physiology , of plants.

[ 1 ] Cell biology – study of the cell as a complete unit, and the molecular and chemical interactions that occur within a living cell.

Histology – study of the anatomy of cells and tissues of plants and animals using microscopy.

Chronobiology – field of biology that examines periodic (cyclic) phenomena in living organisms and their adaptation to solar- and lunar-related rhythms.

Dendrochronology – study of tree rings, using them to date the exact year they were formed in order to analyze atmospheric conditions during different periods in natural history.

Developmental biology – study of the processes through which an organism forms, from zygote to full structure Embryology – study of the development of embryo (from fecundation to birth).

Gerontology – study of aging processes.

Ecology – study of the interactions of living organisms with one another and with the non-living elements of their environment.

Behavioral ecology – the study of the evolutionary basis for animal behavior due to ecological pressure Ecosystem ecology – study of biotic and abiotic components of ecosystems and their interactions within an ecosystem Landscape ecology – study of relationships between ecological processes in the environment and particular ecosystems Microbial ecology – study of the relationships between microorganisms and their environments Population ecology – study of dynamics of species populations and how these populations interact with the environment Urban ecology – study of the relationships between living organisms with each other and their urban environment .

Biogeography – study of the distribution of species spatially and temporally.

Evolutionary biology – study of the origin and descent of species over time.

Evolutionary developmental biology – field of biology that compares the developmental processes of different organisms to determine the ancestral relationship between them, and to discover how developmental processes evolved.

Paleobiology – discipline which combines the methods and findings of the life sciences with the methods and findings of the earth science, paleontology.

Paleoanthropology – the study of fossil evidence for human evolution , mainly using remains from extinct hominin and other primate species to determine the morphological and behavioral changes in the human lineage, as well as the environment in which human evolution occurred.

Paleobotany – study of fossil plants.

Paleontology – study of fossils and sometimes geographic evidence of prehistoric life.

Paleopathology – the study of pathogenic conditions observable in bones or mummified soft tissue, and on nutritional disorders, variation in stature or morphology of bones over time, evidence of physical trauma, or evidence of occupationally derived biomechanic stress.

Genetics – study of genes and heredity.

Molecular genetics – study of the bimolecular mechanisms behind the structure and function of DNA Quantitative genetics – study of phenotypes that vary continuously (in characters such as height or mass)—as opposed to discretely identifiable phenotypes and gene-products (such as eye-colour, or the presence of a particular biochemical).

Marine biology – study of ocean ecosystems, plants, animals, and other living beings.

Microbiology – study of microscopic organisms (microorganisms) and their interactions with other living things.

Bacteriology – study of bacteria Immunology – study of immune systems in all organisms.

Mycology – study of fungi Parasitology – study of parasites and parasitism.

Virology – study of viruses Biochemistry Molecular biology – study of biology and biological functions at the molecular level, with some cross over from biochemistry.

Structural biology – a branch of molecular biology , biochemistry , and biophysics concerned with the molecular structure of biological macromolecules.

Health sciences and human biology – biology of humans.

Medicine – Diagnosis, treatment, and prevention of illness.

Endocrinology – study of the endocrine system.

Oncology – study of cancer processes, including virus or mutation , oncogenesis , angiogenesis , and tissues remoldings.

Pharmacology – study of medication and drugs Epidemiology – major component of public health research, studying factors affecting the health of populations.

Neuroscience – study of the nervous system, including anatomy, physiology and emergent proprieties.

Behavioral neuroscience – study of physiological , genetic , and developmental mechanisms of behavior in humans and other animals.

Cellular neuroscience – study of neurons at a cellular level.

Cognitive neuroscience – study of biological substrates underlying cognition, with a focus on the neural substrates of mental processes.

Computational neuroscience – study of the information processing functions of the nervous system, and the use of digital computers to study the nervous system.

Developmental neuroscience – study of the cellular basis of brain development and addresses the underlying mechanisms.

Molecular neuroscience – studies the biology of the nervous system with molecular biology, molecular genetics, protein chemistry and related methodologies.

Neuroanatomy – study of the anatomy of nervous tissue and neural structures of the nervous system.

Neuroendocrinology – studies the interaction between the nervous system and the endocrine system, that is how the brain regulates the hormonal activity in the body.

Neuroethology – study of animal behavior and its underlying mechanistic control by the nervous system.

Neuroimmunology – study of the nervous system, and immunology, the study of the immune system.

Neuropharmacology – study of how drugs affect cellular function in the nervous system.

Neurophysiology – study of the function (as opposed to structure) of the nervous system.

Systems neuroscience – studies the function of neural circuits and systems.

Theoretical Biology – the mathematical modeling of biological phenomena.

Systems biology – computational modeling of biological systems.

Zoology – study of animals, including classification, physiology, development, and behavior. Subbranches include: Arthropodology – biological discipline concerned with the study of arthropods, a phylum of animals that include the insects, arachnids, crustaceans and others that are characterized by the possession of jointed limbs.

Acarology – study of the taxon of arachnids that contains mites and ticks.

Arachnology – scientific study of spiders and related animals such as scorpions, pseudoscorpions, harvestmen, collectively called arachnids.

Entomology – study of insects.

Coleopterology – study of beetles.

Lepidopterology – study of a large order of insects that includes moths and butterflies (called lepidopterans).

Myrmecology – scientific study of ants.

Carcinology – study of crustaceans.

Myriapodology – study of centipedes, millipedes, and other myriapods.

Ethology – scientific study of animal behavior, usually with a focus on behavior under natural conditions.

Helminthology – study of worms, especially parasitic worms.

Herpetology – study of amphibians (including frogs, toads, salamanders, newts, and gymnophiona) and reptiles (including snakes, lizards, amphisbaenids, turtles, terrapins, tortoises, crocodilians, and the tuataras).

Batrachology – subdiscipline of herpetology concerned with the study of amphibians alone.

Ichthyology – study of fishes. This includes bony fishes (Osteichthyes), cartilaginous fishes (Chondrichthyes), and jawless fishes (Agnatha).

Malacology – branch of invertebrate zoology which deals with the study of the Mollusca (mollusks or molluscs), the second-largest phylum of animals in terms of described species after the arthropods.

Teuthology – branch of Malacology which deals with the study of cephalopods .

Mammalogy – study of mammals, a class of vertebrates with characteristics such as homeothermic metabolism, fur, four-chambered hearts, and complex nervous systems. Mammalogy has also been known as "mastology," "theriology," and "therology." There are about 4,200 different species of animals which are considered mammals.

Cetology – branch of marine mammal science that studies the approximately eighty species of whales, dolphins, and porpoise in the scientific order Cetacea.

Primatology – scientific study of primates Human biology – interdisciplinary field studying the range of humans and human populations via biology/life sciences, anthropology/social sciences, applied/medical sciences Biological anthropology – subfield of anthropology that studies the physical morphology, genetics and behavior of the human genus, other hominins and hominids across their evolutionary development Human behavioral ecology – the study of behavioral adaptations (foraging, reproduction, ontogeny) from the evolutionary and ecologic perspectives (see behavioral ecology ). It focuses on human adaptive responses (physiological, developmental, genetic) to environmental stresses.

Nematology – scientific discipline concerned with the study of nematodes, or roundworms.

Ornithology – scientific study of birds.

Interdisciplinary fields Astrobiology – study of potential life outside of Earth .

Bioarchaeology – study of human and animal remains from archaeological sites.

Geobiology – study of the interactions between the physical Earth and the biosphere .

Biolinguistics – biological study of language .

Biological anthropology – study of the development of the human species.

Biologists [ edit ] Main article: Biologist Lists of notable biologists List of notable biologists List of Nobel Prize winners in physiology or medicine Lists of biologists by author abbreviation List of authors of names published under the ICZN Lists of biologists by subject Main category: Lists of biologists List of biochemists List of ecologists List of neuroscientists List of physiologists See also [ edit ] Biology portal Bibliography of biology Earliest known life forms Invasion biology terminology List of omics topics in biology Related outlines Outline of life forms Outline of zoology Outline of engineering Outline of technology List of social sciences Journals Biology journals References [ edit ] ^ Frank B. Salisbury; Cleon W. Ross (1992).

Plant physiology . Brooks/Cole Pub Co.

ISBN 0-534-15162-0 .

External links [ edit ] Biology at Wikipedia's sister projects Definitions from Wiktionary Media from Commons News from Wikinews Quotations from Wikiquote Texts from Wikisource Textbooks from Wikibooks Resources from Wikiversity Wikibooks has more on the topic of: Outline of biology Look up outline of biology in Wiktionary, the free dictionary.

OSU's Phylocode The Tree of Life : A multi-authored, distributed Internet project containing information about phylogeny and biodiversity.

MIT video lecture series on biology A wiki site for protocol sharing run from MIT .

Biology and Bioethics .

Biology online wiki dictionary .

Biology Video Sharing Community .

What is Biotechnology Archived 19 April 2012 at the Wayback Machine : a voluntary program as Biotech for Beginners.

v t e Branches of biology Abiogenesis Aerobiology Agronomy Agrostology Anatomy Anthropogeny Anthropology Astrobiology Bacteriology Biochemistry Biogeography Biogeology Bioinformatics Biological engineering Biomathematics Biomechanics Biophysics Biosemiotics Biostatistics Biotechnology Botany Cell biology Cellular microbiology Chemical biology Chronobiology Cognitive biology Computational biology Conservation biology Cryobiology Cytogenetics Dendrology Developmental biology Ecological genetics Ecology Embryology Epidemiology Epigenetics Evolutionary biology Freshwater biology Generative biology Genetics Genomics Geobiology Gerontology Herpetology Histology Human biology Ichthyology Immunology Lipidology Mammalogy Marine biology Microbiology Molecular biology Mycology Neontology Neuroscience Nutrition Ornithology Osteology Paleontology Parasitology Pathology Pharmacology Photobiology Phycology Phylogenetics Physiology Pomology Primatology Proteomics Protistology Quantum biology Relational biology Reproductive biology Sociobiology Structural biology Synthetic biology Systematics Systems biology Taxonomy Teratology Toxicology Virology Virophysics Welfare biology Xenobiology Zoology See also History of biology Nobel Prize in Physiology or Medicine Timeline of biology and organic chemistry v t e Biology Introduction ( Genetics , Evolution ) Outline History Timeline Index Biology Overview Science Life Properties ( Adaptation , Energy processing , Growth , Order , Regulation , Reproduction ( Self-replication ), Response to environment ) Hierarchy of life ( Atom > Molecule > Organelle > Cell > Tissue > Organ > Organ system > Organism > Population > Community > Ecosystem > Biosphere ) Reductionistic Emergent property Mechanistic Scientific method Taxonomic rank Theory Law Peer review Biology journals Common name Chemical basis Atoms Amino acids Carbohydrates Chemical bond Chemical element Lipids Matter Quantum Molecules Monomer Nucleic acids Organic compounds pH Polymer Proteins Water Cells ATP Cell cycle Cell theory Cell signaling Cellular respiration Energy transformation Enzyme Eukaryote Fermentation Metabolism Meiosis Mitosis Photosynthesis Prokaryote Genetics DNA Epigenetics Evolutionary developmental biology Gene expression Gene regulation Genomes Mendelian inheritance Post-transcriptional modification Evolution Adaptation Earliest known life forms Function Genetic drift Gene flow History of life Macroevolution Microevolution Mutation Natural selection Phylogenetics Speciation Taxonomy Diversity Archaea Bacteria Eukaryote Alga Animal Fungus Plant Protist Virus Plant form and function Epidermis (botany) Flower Ground tissue Leaf Phloem Plant stem Root Shoot Vascular plant Vascular tissue Xylem Animal form and function Breathing Circulatory system Endocrine system Digestive system Homeostasis Immune system Internal environment Muscular system Nervous system Reproductive system Respiratory system Ecology Biogeochemical cycle Biological interaction Biomass Biomes Biosphere Climate Climate change Community Conservation Ecosystem Habitat niche Microbiome Population dynamics Resources Research methods Laboratory techniques Genetic engineering Transformation Gel electrophoresis Chromatography Centrifugation Cell culture DNA sequencing DNA microarray Green fluorescent protein vector Enzyme assay Protein purification Western blot Northern blot Southern blot Restriction enzyme Polymerase chain reaction Two-hybrid screening in vivo in vitro in silico Field techniques Belt transect mark and recapture species discovery curve Branches Abiogenesis Aerobiology Agronomy Agrostology Anatomy Anthropogeny Anthropology Astrobiology Bacteriology Biochemistry Biogeography Biogeology Bioinformatics Biological engineering Biomathematics Biomechanics Biophysics Biosemiotics Biostatistics Biotechnology Botany Cell biology Cellular microbiology Chemical biology Chronobiology Cognitive biology Computational biology Conservation biology Cryobiology Cytogenetics Dendrology Developmental biology Ecological genetics Ecology Embryology Epidemiology Epigenetics Evolutionary biology Freshwater biology Generative biology Genetics Genomics Geobiology Gerontology Herpetology Histology Human biology Ichthyology Immunology Lipidology Mammalogy Marine biology Microbiology Molecular biology Mycology Neontology Neuroscience Nutrition Ornithology Osteology Paleontology Parasitology Pathology Pharmacology Photobiology Phycology Phylogenetics Physiology Pomology Primatology Proteomics Protistology Quantum biology Relational biology Reproductive biology Sociobiology Structural biology Synthetic biology Systematics Systems biology Taxonomy Teratology Toxicology Virology Virophysics Welfare biology Xenobiology Zoology Glossaries Biology Botanical terms Ecological terms Plant morphology terms Biology portal Category Commons WikiProject v t e Wikipedia outlines General reference Culture and the arts Geography and places Health and fitness History and events Mathematics and logic Natural and physical sciences People and self Philosophy and thinking Religion and belief systems Society and social sciences Technology and applied sciences NewPP limit report
Parsed by mw‐web.codfw.main‐5f4c8b576f‐j88fz
Cached time: 20250814081418
Cache expiry: 2592000
Reduced expiry: false
Complications: [vary‐revision‐sha1, show‐toc]
CPU time usage: 0.606 seconds
Real time usage: 0.862 seconds
Preprocessor visited node count: 2443/1000000
Revision size: 36343/2097152 bytes
Post‐expand include size: 108206/2097152 bytes
Template argument size: 1487/2097152 bytes
Highest expansion depth: 12/100
Expensive parser function count: 9/500
Unstrip recursion depth: 1/20
Unstrip post‐expand size: 53996/5000000 bytes
Lua time usage: 0.286/10.000 seconds
Lua memory usage: 5774460/52428800 bytes
Number of Wikibase entities loaded: 1/500 Transclusion expansion time report (%,ms,calls,template)
100.00%  577.766      1 -total
 25.91%  149.688      1 Template:TopicTOC-Biology
 25.62%  148.035      1 Template:Sidebar_with_collapsible_lists
 15.29%   88.336      1 Template:Reflist
 14.39%   83.132      1 Template:Sister_project_links
 13.78%   79.606      5 Template:Navbox
 13.14%   75.919      1 Template:Cite_book
 11.41%   65.936      2 Template:Excerpt
 11.07%   63.965      1 Template:Short_description
  7.81%   45.117      1 Template:Biology_nav Saved in parser cache with key enwiki:pcache:4493:|#|:idhash:canonical and timestamp 20250814081418 and revision id 1302162035. Rendering was triggered because: page-view Retrieved from " https://en.wikipedia.org/w/index.php?title=Outline_of_biology&oldid=1302162035 " Categories : Outlines of sciences Outlines Biology-related lists Hidden categories: Articles with short description Short description is different from Wikidata Use dmy dates from September 2017 Articles with excerpts Pages using Sister project links with default search Webarchive template wayback links This page was last edited on 23 July 2025, at 19:10 (UTC) .

Text is available under the Creative Commons Attribution-ShareAlike 4.0 License ;
additional terms may apply. By using this site, you agree to the Terms of Use and Privacy Policy . Wikipedia® is a registered trademark of the Wikimedia Foundation, Inc.

, a non-profit organization.

Privacy policy About Wikipedia Disclaimers Contact Wikipedia Code of Conduct Developers Statistics Cookie statement Mobile view Search Search Toggle the table of contents Outline of biology 9 languages Add topic

